You're in Rivet City, the city made in an old aircraft carrier. Pretty good place after the nuclear holocaust. The goal is to find a scientist known as Pinkerton who has barricaded himself in the lower half of the ship. He knows the history of this city and you're job is to find out more about it. In order to get to him you're going to have to go through the bow. There seems to be a mysterious old door to the south, better check that out first.

FIND THE SCIENTIST
An Interactive Fiction by Harrison Yeh
Release 1 / Serial number 130318 / Inform 7 build 6G60 (I6/v6.32 lib 6/12N) SD

Rivet City Entrance
A busling lively city, full with a market place to the east, bar and hotel.. But remember your task, finding Pinkerton won't be so easy. There's a cabinet here.

A greeter sits by the entrance of rivet city.

A security guard stands by the door.

You can also see an exit here.

>north
That noun did not make sense in this context.

>north
Old Closet
A old closet with a rusty stand and some keys.

On Rusty Stand is Keys.

>take all
(Keys)
Taken.

>south
Rivet City
A busling lively city, full with a market place to the east, bar and hotel.. But remember your task, finding Pinkerton won't be so easy.

A greeter sits by the entrance of rivet city.

Rivet City is well protected.

You can also see an exit here.

>south
(first opening the exit)
It seems to be locked.

>unlock exit
(with Keys)
You unlock the exit.

* * *

>up
There is nothing in that direction.

>north
Old Closet
A old closet with a rusty stand and some keys.

On Rusty Stand is Keys.

* * *

>south
(first opening the exit)
It seems to be locked.

>unlock door
(with Keys)
You unlock the exit.

>south
(first opening the exit)

Entrance to Bow
Well no place to go but down!

You can see an exit here.

>south
Lower Bow
There appears to be an old armory here to the left. Better go through the stuff just in case but I'm not expecting any laser tech. There's also a stairway to the Engine Room.

>west
Armory
Well, might as well take this old gun.

>take all
your Combat Shotgun: Taken.

>east
Lower Bow
There appears to be an old armory here to the left. Better go through the stuff just in case but I'm not expecting any laser tech. There's also a stairway to the Engine Room.

>south
Engine
Mutated hostile creatures are wandering around.

You can see Mirelurk, Mutated Crab and Super Mutant here.

* * *

>x shrapnel
You can't see any such thing.

>north
Old Closet
A old closet with a rusty stand and some keys.

On Rusty Stand is Keys.

* * *

>take all
(Keys)
Taken.

>south
Rivet City
A busling lively city, full with a market place, bar and hotel.. But remember your task, finding Pinkerton won't be so easy.

A greeter sits by the entrance of rivet city.

Rivet City is well protected.

You can also see an exit here.

* * *

>west
There is nothing in that direction.

>EAST
Entrance to bow
Well no place to go but down!

>south
Lower Bow
There appears to be an old armory here to the left. Better go through the stuff just in case but I'm not expecting any laser tech. There's also a stairway to the Engine Room.

* * *

>west
Armory
Well, might as well take this old gun.

>take gun
Taken.

>take all
There are none at all available!

>east
Lower Bow
There appears to be an old armory here to the left. Better go through the stuff just in case but I'm not expecting any laser tech. There's also a stairway to the Engine Room.

>south
Engine
Mutated hostile creatures are wandering around.

You can see Mirelurk here.

>shoot mirelurk
What do you want to shoot Mirelurk with?

>gun
You attack Mirelurk with your Combat Shotgun, causing 32 points of damage!

Mirelurk attacks you with Nothing, causing 0 points of damage!

>south
There is nothing in that direction.

Mirelurk attacks you with Screech, causing 3 points of damage!

>attack mirelurk with gun
You attack with your Combat Shotgun, killing Mirelurk!

* * *

>i
You are carrying nothing.

>go through exit
(first opening the exit)
It seems to be locked.

>e
Market Place
A market place with an ammunitions shop, an attire shop and a resturant. There seems to be a hotel to the north….

>nw
There is nothing in that direction.

>use stimpak
That noun did not make sense in this context.

>use
That noun did not make sense in this context.

>use
That noun did not make sense in this context.

>e
There is nothing in that direction.

>go to attire shop
That noun did not make sense in this context.

>n
Hotel
There seems to be an old caretaker and a robbot butler named "Mr Gusty"

Seems senile… Talking to her won't do any good.

He says "How may I help you sir?" but doesn't seem to know anything.

On the Counter is Shades.

>take shades
Taken.

>use shades
That noun did not make sense in this context.

* * *

>take all
Hey stop that! All is disabled.

* * *

>talk to security guard
"Huh? Pinkerton? That old coot hasn't been seen around here for years. Anyways there's tons of people you could ask. I would start with the Bar."

* * *

>open cabinet
You open Cabinet, revealing Bottlecaps.

>take bottlecaps
Taken.

* * *

>east
Market Place
A market place with an ammunitions shop, an attire shop and a resturant. There seems to be a hotel to the north….

>north
Hotel
There seems to be an old caretaker and a robbot butler named "Mr Gusty"

On the counter are a Stimpak x 0 and Shades.

Seems senile… Talking to her won浡摥∠牍䜠獵祴ਢ't do any good.

He says "How may I help you sir?" but doesn't seem to know anything.

You can also see Bomb kit here.

>TAKE STIMPAK
Taken.

>use stimpak
I only understood you as far as wanting to use.

>use stimpak
I only understood you as far as wanting to use.

>eat stimpak
Your health has been replenished!
(Health: 150)

>use stimpak
I only understood you as far as wanting to use.

>eat stimpak
Your health has been replenished!
(Health: 200)

>eat stimpak
Your health has been replenished!
(Health: 250)

>eat stimpak
Your health has been replenished!
(Health: 300)

>eat stimpak
Your health has been replenished!
(Health: 350)

>eat stimpak
Your health has been replenished!
(Health: 400)

>eat stimpak
Your health has been replenished!
(Health: 450)

I beg your pardon?

I beg your pardon?

>eat stimpak
Your health has been replenished!
(Health: 500)

>eat stimpak
Your health has been replenished!
(Health: 550)

>eat stimpak
Your health has been replenished!
(Health: 600)

>eat stimpak
Your health has been replenished!
(Health: 650)

>eat stimpak
Your health has been replenished!
(Health: 700)

>eat stimpak
Your health has been replenished!
(Health: 750)

>eat stimpak
Your health has been replenished!
(Health: 800)

>eat stimpak
Your health has been replenished!
(Health: 850)

>eat stimpak
Your health has been replenished!
(Health: 900)

>eat stimpak
Your health has been replenished!
(Health: 950)

>eat stimpak
Your health has been replenished!
(Health: 1000)

>eat stimpak
Your health has been replenished!
(Health: 1050)

>eat stimpak
Your health has been replenished!
(Health: 1100)

>eat stimpak
Your health has been replenished!
(Health: 1150)

>eat stimpak
Your health has been replenished!
(Health: 1200)

>eat stimpak
Your health has been replenished!
(Health: 1250)

>eat stimpak
Your health has been replenished!
(Health: 1300)

>eat stimpak
Your health has been replenished!
(Health: 1350)

>eat stimpak
Your health has been replenished!
(Health: 1400)

>eat stimpak
Your health has been replenished!
(Health: 1450)

>eat stimpak
Your health has been replenished!
(Health: 1500)

* * *

>north
Hotel
There seems to be an old caretaker and a robbot butler named "Mr Gusty"

On the counter are a Stimpak x 0 and Shades.

Seems senile… Talking to her won浡摥∠牍䜠獵祴ਢ't do any good.

He says "How may I help you sir?" but doesn't seem to know anything.

You can also see Bomb kit here.

>take stimpak
Taken.

>eat stimpak
Your health has increased!
(Health: 150)

>eat stimpak
You can't see any such thing.

>eat stimpak
Your health has increased!
(Health: 250)

>eat stimpak
Your health has increased!
(Health: 300)

>eat stimpak
Your health has increased!
(Health: 350)

>eat stimpak
Your health has increased!
(Health: 400)

>eat stimpak
Your health has increased!
(Health: 450)

>eat stimpak
Your health has increased!
(Health: 500)

>eat stimpak
Your health has increased!
(Health: 550)

* * *

>NORTH
Old Closet
A old closet with a rusty stand and some keys.

On Rusty Stand is Keys.

>TAKE KEYS
Taken.

>SOUTH
Rivet City
A busling lively city, full with a market place to the east, bar and hotel.. But remember your task, finding Pinkerton won't be so easy.

A greeter sits by the entrance of rivet city.

Rivet City is well protected.

You can also see an exit here.

>EAST
Market Place
A market place with an ammunitions shop, an attire shop and a resturant.

>WEST
Rivet City
A busling lively city, full with a market place to the east, bar and hotel.. But remember your task, finding Pinkerton won't be so easy.

A greeter sits by the entrance of rivet city.

Rivet City is well protected.

You can also see an exit here.

>WEST
There is nothing in that direction.

>SOUTH
(first opening the exit)
It seems to be locked.

>UNLOCK
(Keys with Keys)
That doesn't seem to be something you can unlock.

>UNLOCK DOOR WITH KEYS
You unlock the exit.

>SOUTH
(first opening the exit)

Entrance to Bow
Well no place to go but down!

You can see an exit here.

>south
Lower Bow
There appears to be an old armory here to the left. Better go through the stuff just in case but I'm not expecting any laser tech. There's also a stairway to the Engine Room.

>WEST
Armory
Well, might as well take this old gun.

>take all
Hey stop that! All is disabled.

>west
There is nothing in that direction.

>east
Lower Bow
There appears to be an old armory here to the left. Better go through the stuff just in case but I'm not expecting any laser tech. There's also a stairway to the Engine Room.

>south
Engine
Mutated hostile creatures are wandering around. Hopefully if I kill enough of them the key will drop. I better take all the loot after killing one.

You can see Corridor, Mirelurk, Mutated Crab and Super Mutant here.

>south
(first opening Corridor)
It seems to be locked.

>attack mutated crab with shotgun
You can't see any such thing.

>attack mutated crab
What do I attack the Mutated Crab with?

>shotgun
That noun did not make sense in this context.

>attack mutated crab with gun
You can't see any such thing.

>north
Lower Bow
There appears to be an old armory here to the left. Better go through the stuff just in case but I'm not expecting any laser tech. There's also a stairway to the Engine Room.

>west
Armory
You already took the gun.

>east
Lower Bow
There appears to be an old armory here to the left. Better go through the stuff just in case but I'm not expecting any laser tech. There's also a stairway to the Engine Room.

* * *

>south
Engine
Mutated hostile creatures are wandering around. Hopefully if I kill enough of them the key will drop. I better take all the loot after killing one.

You can see Corridor, Mirelurk, Mutated Crab and Super Mutant here.

>attack mirelurk with gun
You can't see any such thing.

* * *

>talk to guard
You see nothing special about Security Guard.

>talk to greeter
You explain your mission to the greeter. He is happy to help you and says "You need a key to get to the bow. But no one has been there in a long time."

* * *

>eat
What do you want to eat?

>east
You can't see any such thing.

>north
Old Closet
A old closet with a rusty stand and some keys.

On Rusty Stand is Keys.

>east
There is nothing in that direction.

>south
Rivet City
A busling lively city, full with a market place to the east, bar and hotel.. But remember your task, finding Pinkerton won't be so easy.

A greeter sits by the entrance of rivet city.

Rivet City is well protected.

You can also see an exit here.

>east
Market Place
A market place with an ammunitions shop, an attire shop and a resturant. There seems to be a hotel to the north….

>north
Hotel
There seems to be an old caretaker and a robbot butler named "Mr Gusty"

On the counter are a Stimpak x 1 and Shades.

Seems senile… Talking to her won浡摥∠牍䜠獵祴ਢ't do any good.

He says "How may I help you sir?" but doesn't seem to know anything.

You can also see Bomb kit here.

>take bomb kit
Taken.

>east
There is nothing in that direction.

* * *

>x greeter
You explain your mission to the greeter. He is happy to help you and says "You need a key to get to the bow. But no one has been there in a long time."

>x key
You can't see any such thing.

>talk to greeter
You explain your mission to the greeter. He is happy to help you and says "You need a key to get to the bow. But no one has been there in a long time."

>x key
You can't see any such thing.

>i
You are carrying nothing.

>l
Rivet City
A busling lively city, full with a market place to the east, bar and hotel.. But remember your task, finding Pinkerton won't be so easy.

A greeter sits by the entrance of rivet city.

Rivet City is well protected.

You can also see an exit here.

>s
(first opening the exit)
It seems to be locked.

>x door
The exit leads to the bow, I bet Pinkerton is down there.

>e
Market Place
A market place with an ammunitions shop, an attire shop and a resturant. There seems to be a hotel to the north….

>x ammunitions shop
Ammo and guns everywhere, too bad I'm broke.

>x ammo
You can't see any such thing.

>x guns
You can't see any such thing.

>x attire shop
A store called Patomic Attire, selling some standard goods.

>x goods
You can't see any such thing.

>x resturant
A small little diner with food. Unfortunately I'm not hungry.

>m
That noun did not make sense in this context.

>n
Hallway
A hallway, there's the hotel to the north, a laboratory to the west, and a bar to east.

You can see Lab door here.

>x door
You see nothing special about Lab door.

>x lab door
You see nothing special about Lab door.

>x hotel
You can't see any such thing.

>w
There is nothing in that direction.

>e
There is nothing in that direction.

>w
There is nothing in that direction.

* * *

>x greeter
You explain your mission to the greeter. He is happy to help you and says "You need a key to get to the bow. But no one has been there in a long time."

>x security guard
You see nothing special about Security Guard.

>TAKE POOP
You can't see any such thing.

>north
Old Closet
A old closet with a rusty stand and some keys.

On Rusty Stand is Keys.

* * *

>east
Lower Bow
There appears to be an old armory here to the left. Better go through the stuff just in case but I'm not expecting any laser tech. There's also a stairway to the Engine Room.

>west
Armory
You already took the gun.

* * *

>south
Engine
Mutated hostile creatures are wandering around.

You can see Mirelurk, Mutated Crab and Super Mutant here.

>attack mirelurk
What do I attack the mirelurk with?

>shotgun
That noun did not make sense in this context.

>GUN
That noun did not make sense in this context.

>ATTACK MIRELURK
What do I attack the mirelurk with?

>GUN
That noun did not make sense in this context.

>attack mirelurk with gun
You attack Mirelurk with your Combat Shotgun, causing 31 points of damage!

Mirelurk attacks you with Screech, causing 14 points of damage!

>attack mirelurk with gun
You attack with your Combat Shotgun, killing Mirelurk!

* * *

>SOUTH
(first opening the exit)
It seems to be locked.

>x door
The exit leads to the bow

* * *

>e
Market Place
A market place with an ammunitions shop, an attire shop and a resturant. There seems to be a hotel to the north….

>n
Hallway
A hallway, there's the hotel to the north, a laboratory to the west, and a bar to east.

You can see Lab Door here.

>n
Hotel
There seems to be an old caretaker and a robbot butler named "Mr Gusty"

Seems senile… Talking to her won't do any good.

He says "How may I help you sir?" but doesn't seem to know anything.

You can also see Guest here.

>x robot
You can't see any such thing.

>x butler
You can't see any such thing.

>x mr gutsy
I only understood you as far as wanting to examine Mr Gusty.

>x gutsy
You can't see any such thing.

>talk to mr gutsy
I only understood you as far as wanting to talk to Mr Gusty.

>talk to guest
"Pinkerton? I haven't heard that name for a long time. My guess is that he's in the lower bow."

>talk to guest
"Pinkerton? I haven't heard that name for a long time. My guess is that he's in the lower bow."

>s
Hallway
A hallway, there's the hotel to the north, a laboratory to the west, and a bar to east.

You can see Lab Door here.

>w
(first opening Lab Door)
It seems to be locked.

>e
There is nothing in that direction.

>e
There is nothing in that direction.

>w
(first opening Lab Door)
It seems to be locked.

>n
Hotel
There seems to be an old caretaker and a robbot butler named "Mr Gusty"

Seems senile… Talking to her won't do any good.

He says "How may I help you sir?" but doesn't seem to know anything.

You can also see Guest here.

>x caretakeer
You can't see any such thing.

>x caretaker
You see nothing special about Caretaker.

>talk to caretaker
You see nothing special about Caretaker.

>rape caretaker
That noun did not make sense in this context.

>tlak to mr
That noun did not make sense in this context.

>talk to mr gutsy
I only understood you as far as wanting to talk to Mr Gusty.

>x guest
"Pinkerton? I haven't heard that name for a long time. My guess is that he's in the lower bow."

>talk to gueat
You can't see any such thing.

>kill guest
Violence isn't the answer to this one.

>l
Hotel
There seems to be an old caretaker and a robbot butler named "Mr Gusty"

Seems senile… Talking to her won't do any good.

He says "How may I help you sir?" but doesn't seem to know anything.

You can also see Guest here.

>l
Hotel
There seems to be an old caretaker and a robbot butler named "Mr Gusty"

Seems senile… Talking to her won't do any good.

He says "How may I help you sir?" but doesn't seem to know anything.

You can also see Guest here.

>s
Hallway
A hallway, there's the hotel to the north, a laboratory to the west, and a bar to east.

You can see Lab Door here.

>s
Market Place
A market place with an ammunitions shop, an attire shop and a resturant. There seems to be a hotel to the north….

>s
There is nothing in that direction.

>w
Rivet City
A busling lively city, full with a market place to the east, bar and hotel.. But remember your task, finding Pinkerton won't be so easy.

A greeter sits by the entrance of rivet city.

Rivet City is well protected.

You can also see an exit here.

>w
There is nothing in that direction.

>e
Market Place
A market place with an ammunitions shop, an attire shop and a resturant. There seems to be a hotel to the north….

>e
There is nothing in that direction.

>w
Rivet City
A busling lively city, full with a market place to the east, bar and hotel.. But remember your task, finding Pinkerton won't be so easy.

A greeter sits by the entrance of rivet city.

Rivet City is well protected.

You can also see an exit here.

>s
(first opening the exit)
It seems to be locked.

>n
Old Closet
A old closet with a rusty stand and some keys.

On Rusty Stand is Keys.

>tlak to greeter
That noun did not make sense in this context.

>talk to greeter
You can't see any such thing.

>s
Rivet City
A busling lively city, full with a market place to the east, bar and hotel.. But remember your task, finding Pinkerton won't be so easy.

A greeter sits by the entrance of rivet city.

Rivet City is well protected.

You can also see an exit here.

>talk to greeter
You explain your mission to the greeter. He is happy to help you and says "You need a key to get to the bow. But no one has been there in a long time."

>ask for key
You can't see any such thing.

>n
Old Closet
A old closet with a rusty stand and some keys.

On Rusty Stand is Keys.

>take keys
Taken.

>s
Rivet City
A busling lively city, full with a market place to the east, bar and hotel.. But remember your task, finding Pinkerton won't be so easy.

A greeter sits by the entrance of rivet city.

Rivet City is well protected.

You can also see an exit here.

>e
Market Place
A market place with an ammunitions shop, an attire shop and a resturant. There seems to be a hotel to the north….

* * *

>n
Hallway
A hallway, there's the hotel to the north, a laboratory to the west, and a bar to east.

You can see Lab Door here.

>w
(first opening Lab Door)
It seems to be locked.

>unlock door
(with Keys)
That doesn't seem to fit the lock.

>s
Market Place
A market place with an ammunitions shop, an attire shop and a resturant. There seems to be a hotel to the north….

>e
There is nothing in that direction.

* * *

>s
(first opening the exit)
It seems to be locked.

>unlock door
(with Keys)
You unlock the exit.

>s
(first opening the exit)

Entrance to Bow
Well no place to go but down!

You can see an exit here.

>down
There is nothing in that direction.

>go down
There is nothing in that direction.

>go thorugh exit
You can't see any such thing.

>s
Lower Bow
There appears to be an old armory here to the left. Better go through the stuff just in case but I'm not expecting any laser tech. There's also a stairway to the Engine Room.

>x armory
You can't see any such thing.

>go left
You can't see any such thing.

>w
Armory
Well, might as well take this old gun.

>take gu
You can't see any such thing.

>i
You are carrying:
  Keys

>take gun
Taken.

>x gun
You see nothing special about your Combat Shotgun.

>e
Lower Bow
There appears to be an old armory here to the left. Better go through the stuff just in case but I'm not expecting any laser tech. There's also a stairway to the Engine Room.

>go down stairway
I only understood you as far as wanting to go down.

>s
Engine
Mutated hostile creatures are wandering around. Hopefully if I kill enough of them the key will drop. I better take all the loot after killing one.

You can see Corridor, Mirelurk, Mutated Crab and Super Mutant here.

>x corridor
You see nothing special about Corridor.

>s
(first opening Corridor)
It seems to be locked.

>kill mirelurk
What do I attack the mirelurk with?

>gun
That noun did not make sense in this context.

>shoot mirelurk with gun
You attack with your Combat Shotgun, killing Mirelurk!

The Mirelurk had the key to the corridor!

>take key
(Ancient key)
Taken.

The Mirelurk had the key to the corridor!

>slap super mutant
What do you want to slap Super Mutant with?

>hand
You can't see any such thing.

>slap super mutant with shotgun
You attack Super Mutant with your Combat Shotgun, causing 30 points of damage!

The Mirelurk had the key to the corridor!

>shoot super mutant with combat shotgun
You attack with your Combat Shotgun, killing Super Mutant!

The Mirelurk had the key to the corridor!

>x super mutant
You can't see any such thing.

>l
Engine
Mutated hostile creatures are wandering around. Hopefully if I kill enough of them the key will drop. I better take all the loot after killing one.

You can see Ancient key, Corridor and Mutated Crab here.

The Mirelurk had the key to the corridor!

>kill mutated crab with shotgun
You attack Mutated Crab with your Combat Shotgun, causing 16 points of damage!

The Mirelurk had the key to the corridor!

>kill mutated crab with shotgun
You attack with your Combat Shotgun, killing Mutated Crab!

The Mirelurk had the key to the corridor!

>kill mutated crab with shotgun
You can't see any such thing.

>kill mutated crab with shotgun
You can't see any such thing.

>unlock door
What do you want to unlock Corridor with?

>key
(Keys)
That doesn't seem to fit the lock.

The Mirelurk had the key to the corridor!

>unlock corridor with ancient key
(first taking Ancient key)
Keys won't do it, the ancient keys would work better.

The Mirelurk had the key to the corridor!

>i
You are carrying:
  your Combat Shotgun
  Keys

The Mirelurk had the key to the corridor!

>l
Engine
Mutated hostile creatures are wandering around. Hopefully if I kill enough of them the key will drop. I better take all the loot after killing one.

You can see Ancient key and Corridor here.

The Mirelurk had the key to the corridor!

>take key
(Ancient key)
Taken.

The Mirelurk had the key to the corridor!

>unlock corridor
What do you want to unlock Corridor with?

>ancient key
(first taking Ancient key)
Keys won't do it, the ancient keys would work better.

The Mirelurk had the key to the corridor!

>unlock door with ancient keys
I only understood you as far as wanting to unlock Corridor with Ancient key.

>s
(first opening Corridor)
It seems to be locked.

The Mirelurk had the key to the corridor!

>s
(first opening Corridor)
It seems to be locked.

The Mirelurk had the key to the corridor!

I beg your pardon?

>e
There is nothing in that direction.

The Mirelurk had the key to the corridor!

>w
There is nothing in that direction.

    *** Game Over ***

In that game you scored 0 out of a possible 0, in 73 turns.

Would you like to RESTART, RESTORE a saved game, QUIT or UNDO the last command?

>health
Please give one of the answers above.

Would you like to RESTART, RESTORE a saved game, QUIT or UNDO the last command?

* * *

>north
Old Closet
A old closet with a rusty stand and some keys.

On Rusty Stand is Keys.

* * *

>take all
(Keys)
Taken.

>south
Rivet City Entrance
A busling lively city, full with a market place to the east, bar and hotel.. But remember your task, finding Pinkerton won't be so easy.

A greeter sits by the entrance of rivet city.

Rivet City is well protected.

You can also see an exit here.

>east
Market Place
A market place with an ammunitions shop, an attire shop and a resturant. There seems to be a hotel to the north….

>north
Hallway
A hallway, there's the hotel to the north, a laboratory to the west, and a bar to east.

You can see Lab Door here.

>north
Hotel
There seems to be an old caretaker and a robbot butler named "Mr Gusty"

Seems senile… Talking to her won't do any good.

He says "How may I help you sir?" but doesn't seem to know anything.

You can also see Guest here.

>talk to guest
"Pinkerton? I haven't heard that name for a long time. My guess is that he's in the lower bow."

>east
Mysterious Hotel Room
This room is the only unlocked room in the hotel… There's a lot of weird things here.

On the Night Stand are a Stimpak x 1, Shades and Bomb kit.

>take stimpak
Taken.

>take shades
Taken.

>take bomb kit
Taken.

>wear shades
You put on Shades.

>x shades
These shades are pretty cool! They appear to have belonged to a store called "Lucky's"

>WEST
Hotel
There seems to be an old caretaker and a robbot butler named "Mr Gusty"

Seems senile… Talking to her won't do any good.

He says "How may I help you sir?" but doesn't seem to know anything.

You can also see Guest here.

>south
Hallway
A hallway, there's the hotel to the north, a laboratory to the west, and a bar to east.

You can see Lab Door here.

>south
Market Place
A market place with an ammunitions shop, an attire shop and a resturant. There seems to be a hotel to the north….

>west
Rivet City Entrance
A busling lively city, full with a market place to the east, bar and hotel.. But remember your task, finding Pinkerton won't be so easy.

A greeter sits by the entrance of rivet city.

Rivet City is well protected.

You can also see an exit here.

>south
(first opening the exit)
It seems to be locked.

>unlock door
What do you want to unlock the exit with?

>with keys
You can't see any such thing.

>unlock door with keys
You unlock the exit.

>SOUTH
(first opening the exit)

Entrance to Bow
Well no place to go but down!

You can see an exit here.

* * *

>take gun
Taken.

>west
There is nothing in that direction.

* * *

>east
Lower Bow
There appears to be an old armory here to the left. Better go through the stuff just in case but I'm not expecting any laser tech. There's also a stairway to the Engine Room.

>south
Engine
Mutated hostile creatures are wandering around. Hopefully if I kill enough of them the key will drop. I better take all the loot after killing one. There also seems to be radiation here. Better work fast and pay attention to my health.

You can see Corridor, Mirelurk, Mutated Crab and Super Mutant here.

>attack mirelurk
What do I attack the mirelurk with?

>attack mirelurk with gun
You attack Mirelurk with your Combat Shotgun, causing 47 points of damage!

Mirelurk attacks you with Nothing, causing 0 points of damage!

>attack mirelurk with gun
You attack with your Combat Shotgun, killing Mirelurk!

The Mirelurk had the key to the corridor!

>TAKE KEY
(Ancient key)
Taken.

The Mirelurk had the key to the corridor!

>south
(first opening Corridor)
It seems to be locked.

The Mirelurk had the key to the corridor!

>unlcok corridor with ancient key
That noun did not make sense in this context.

>unlock corridor with ancient key
(first taking Ancient key)
Keys won't do it, the ancient keys would work better.

The Mirelurk had the key to the corridor!

* * *

>north
Old Closet
A old closet with a rusty stand and some keys.

On Rusty Stand is Keys.

>take gun
You can't see any such thing.

>south
Rivet City Entrance
A busling lively city, full with a market place to the east, bar and hotel.. But remember your task, finding Pinkerton won't be so easy.

A greeter sits by the entrance of rivet city.

Rivet City is well protected.

You can also see an exit here.

>north
Old Closet
A old closet with a rusty stand and some keys.

On Rusty Stand is Keys.

>take keys
Taken.

>SOUTH
Rivet City Entrance
A busling lively city, full with a market place to the east, bar and hotel.. But remember your task, finding Pinkerton won't be so easy.

A greeter sits by the entrance of rivet city.

Rivet City is well protected.

You can also see an exit here.

>east
Market Place
A market place with an ammunitions shop, an attire shop and a resturant. There seems to be a hotel to the north….

* * *

>north
Hallway
A hallway, there's the hotel to the north, a laboratory to the west, and a bar to east.

You can see Lab Door here.

>north
Hotel
There seems to be an old caretaker and a robbot butler named "Mr Gusty". There also appears to be an old hotel room to the east.

The lady Seems senile… Talking to her wonoo't do any good.

The robot says "How may I help you sir?" but doesn't seem to know anything.

You can also see Guest here.

>east
Mysterious Hotel Room
This room is the only unlocked room in the hotel… There's a lot of weird things here.

On the Night Stand are a Stimpak x 1, Shades and Bomb kit.

* * *

>take stimpak
Taken.

>take bomb kit
Taken.

>south
There is nothing in that direction.

>south
There is nothing in that direction.

>east
There is nothing in that direction.

>west
Hotel
There seems to be an old caretaker and a robbot butler named "Mr Gusty". There also appears to be an old hotel room to the east.

The lady Seems senile… Talking to her won't do any good.

The robot says "How may I help you sir?" but doesn't seem to know anything.

You can also see Guest here.

>south
Hallway
A hallway, there's the hotel to the north, a laboratory to the west, and a bar to east.

You can see Lab Door here.

* * *

>south
(first opening the exit)
It seems to be locked.

>unlock door with keys
You unlock the exit.

>south
(first opening the exit)

Entrance to Bow
Well no place to go but down!

You can see an exit here.

* * *

>south
Lower Bow
There appears to be an old armory here to the left. Better go through the stuff just in case but I'm not expecting any laser tech. There's also a stairway to the Engine Room.

>east
There is nothing in that direction.

>west
Armory
Well, might as well take this old gun.

* * *

>take gun
Taken.

>east
Lower Bow
There appears to be an old armory here to the left. Better go through the stuff just in case but I'm not expecting any laser tech. There's also a stairway to the Engine Room.

* * *

>south
Engine
Mutated hostile creatures are wandering around. Hopefully if I kill enough of them the key will drop. I better take all the loot after killing one. There also seems to be radiation here. Better work fast and pay attention to my health.

You can see Corridor, Mirelurk, Mutated Crab and Super Mutant here.

>attack mirelurk with gun
You attack Mirelurk with your Combat Shotgun, causing 15 points of damage!

Mirelurk attacks you with Claws, causing 14 points of damage!

>attack mirelurk with gun
You attack with your Combat Shotgun, killing Mirelurk!

The Mirelurk had the key to the corridor!

>use STIMPAK
I only understood you as far as wanting to use.

>eat stimpak
Your health has increased!
(Health: 121)
The Mirelurk had the key to the corridor!

>take key
(Ancient key)
Taken.

The Mirelurk had the key to the corridor!

>unlock corridor with key
(Keys)
That doesn't seem to fit the lock.

The Mirelurk had the key to the corridor!

>unlock corridor with ancient key
(first taking Ancient key)
Keys won't do it, the ancient keys would work better.

The Mirelurk had the key to the corridor!

>unlock corridor with ancient key
(first taking Ancient key)
Keys won't do it, the ancient keys would work better.

The Mirelurk had the key to the corridor!

* * *

>take keys
Taken.

>south
Rivet City Entrance
A busling lively city, full with a market place to the east, bar and hotel.. But remember your task, finding Pinkerton won't be so easy.

A greeter sits by the entrance of rivet city.

Rivet City is well protected.

You can also see an exit here.

* * *

>south
There is nothing in that direction.

>wesat
That noun did not make sense in this context.

>w
Hotel
There seems to be an old caretaker and a robbot butler named "Mr Gusty". There also appears to be an old hotel room to the east.

The lady Seems senile… Talking to her wonoo't do any good.

The robot says "How may I help you sir?" but doesn't seem to know anything.

You can also see Guest here.

>s
Hallway
A hallway, there's the hotel to the north, a laboratory to the west, and a bar to east.

You can see Lab Door here.

* * *

>s
Market Place
A market place with an ammunitions shop, an attire shop and a resturant. There seems to be a hotel to the north….

>w
Rivet City Entrance
A busling lively city, full with a market place to the east, bar and hotel.. But remember your task, finding Pinkerton won't be so easy.

A greeter sits by the entrance of rivet city.

Rivet City is well protected.

You can also see an exit here.

>s
(first opening the exit)
It seems to be locked.

>unlock door with key
You unlock the exit.

>s
(first opening the exit)

Entrance to Bow
Well no place to go but down!

You can see an exit here.

>s
Lower Bow
There appears to be an old armory here to the left. Better go through the stuff just in case but I'm not expecting any laser tech. There's also a stairway to the Engine Room.

>w
Armory
Well, might as well take this old gun.

>take gun
Taken.

>w
There is nothing in that direction.

>e
Lower Bow
There appears to be an old armory here to the left. Better go through the stuff just in case but I'm not expecting any laser tech. There's also a stairway to the Engine Room.

>s
Engine
Mutated hostile creatures are wandering around. Hopefully if I kill enough of them the key will drop. I better take all the loot after killing one. There also seems to be radiation here. Better work fast and pay attention to my health.

You can see Corridor, Mirelurk, Mutated Crab and Super Mutant here.

>s
(first opening Corridor)
It seems to be locked.

>attack mirelurk with gun
You attack with your Combat Shotgun, killing Mirelurk!

The Mirelurk had the key to the corridor!

>take key
(Ancient key)
Taken.

The Mirelurk had the key to the corridor!

* * *

>unlock corridor with key
(Keys)
That doesn't seem to fit the lock.

The Mirelurk had the key to the corridor!

>UNLOCK CORRIDOR WITH ANCIENT KEY
(first taking Ancient key)
You unlock Corridor.

The Mirelurk had the key to the corridor!

>s
(first opening Corridor)

stairwell
I think this is the way to the lab…

You can see Corridor and a mine here.

The Mirelurk had the key to the corridor!