You're in Rivet City. The goal is to find a scientist known as Pinkerton who has barricaded himself in the lower half of the ship. In order to get to him you're going to have to go through the bow. There seems to be a mysterious old door to the south, better check that out first.

FIND THE SCIENTIST
An Interactive Fiction by Harrison Yeh
Release 1 / Serial number 130306 / Inform 7 build 6G60 (I6/v6.32 lib 6/12N) SD

Rivet City
A busling lively city, full with a market place to the east, bar and hotel.. But remember your task, finding Pinkerton won't be so easy.

A greeter sits by the entrance of rivet city.

Rivet City is well protected.

You can also see an exit here.

>north
That noun did not make sense in this context.

* * *

>up
There is nothing in that direction.

* * *

>attack guard
Violence isn't the answer to this one.

>attack joe
Don't need to attack him.

>x me
As good-looking as ever.

* * *

>TALK TO JOE
That noun did not make sense in this context.

>speak to joe
I didn't understand that sentence.

>x joe
Joe looks at you and says, "You need a key to get to the bow!"

>x security guard
You see nothing special about Security Guard.

>x guard
You see nothing special about Security Guard.

>x soldier
You see nothing special about Security Guard.

>lift
That noun did not make sense in this context.

>north
Old Closet
A old closet with a rusty stand and some keys.

On Rusty Stand is Keys.

* * *

>take keys
Taken.

>south
Rivet City
A busling lively city, full with a market place, bar and hotel.. But remember your task, finding Pinkerton won't be so easy.

Your friend Joe says "Hey! I heard there was a secret room in the city. Try looking around. I heard it's really old and no one has ever been there before."

Rivet City is well protected.

You can also see an exit here.

>west
There is nothing in that direction.

>east
Entrance to bow
There appears to be an old armory here. Better go through the stuff just in case but I'm not expecting any laser tech.

* * *

>south
(first opening the exit)
It seems to be locked.

>WEST
There is nothing in that direction.

>east
Market Place
A market place with an ammunitions shop, an attire shop and a resturant.

>noth
That noun did not make sense in this context.

>north
There is nothing in that direction.

>south
There is nothing in that direction.

>east
Hotel
There seems to be an old caretaker and a robbot butler named "Mr Gusty"

Seems senile… Talking to her won't do any good.

He says "How may I help you sir?" but doesn't seem to know anything.

On Counter is Shades.

>EAST
There is nothing in that direction.

>NORTH
There is nothing in that direction.

>SOUTH
There is nothing in that direction.

>EAST
There is nothing in that direction.

* * *

>x shrapnel
You can't see any such thing.

* * *

>x rivet city
You can't see any such thing.

* * *

>x me
I'm so cool. My sheriff's hat and shades could attract any lady of the wasteland.

* * *

>x exit
The exit leads to the bow

>x rivet city
You can't see any such thing.

>x joe
Joe looks at you and says, "You need a key to get to the bow!."

>attack joe
Don't need to attack him.

>attack guard
Violence isn't the answer to this one.

* * *

>x exit
The exit leads to the bow

>west
There is nothing in that direction.

>west
There is nothing in that direction.

>south
Entrance to bow
Well no place to go but down!

>south
Lower Bow
There appears to be an old armory here to the left. Better go through the stuff just in case but I'm not expecting any laser tech. There's also a stairway to the Engine Room.

>south
Engine
Mutated hostile creatures are wandering around.

You can see Mirelurk, Mutated Crab and Super Mutant here.

* * *

>sout
That noun did not make sense in this context.

>south
(first opening the exit)
It seems to be locked.

* * *

>unlock door
What do you want to unlock the exit with?

>keys
You can't see any such thing.

* * *

>x greeter
You explain your mission to the greeter. He is happy to help you and says "You need a key to get to the bow. But no one has been there in a long time."

* * *

>north
Old Closet
A old closet with a rusty stand and some keys.

On Rusty Stand is Keys.

* * *

>east
Lower Bow
There appears to be an old armory here to the left. Better go through the stuff just in case but I'm not expecting any laser tech. There's also a stairway to the Engine Room.

>south
Engine
Mutated hostile creatures are wandering around.

You can see Corridor, Mirelurk, Mutated Crab and Super Mutant here.

>attack mirelurk
What do I attack the mirelurk with?

* * *

>shotgun
That noun did not make sense in this context.

>attack mirelurk with shotgun
You attack with your Combat Shotgun, killing Mirelurk!

>TAKE ALL
Ancient key: Taken.
Pinchers: That seems to belong to Mutated Crab.
Assault Rifle: That seems to belong to Mutated Crab.

* * *

>south
Engine
Mutated hostile creatures are wandering around.

You can see Mirelurk, Mutated Crab and Super Mutant here.

>south
There is nothing in that direction.

>attack mirelurk
Violence isn't the answer to this one.

>kill mirelurk
Violence isn't the answer to this one.

>kill mirelurk
Violence isn't the answer to this one.

>kill mutated crab
Violence isn't the answer to this one.

>attack mirelurk
Violence isn't the answer to this one.

>ATTACK MIRELURK WIHT GUN
I only understood you as far as wanting to attack Mirelurk.

>attack mirelurk with gun
You attack Mirelurk with your Combat Shotgun, causing 31 points of damage!

Mirelurk attacks you with Screech, causing 15 points of damage!

>attack mirelurk
Violence isn't the answer to this one.

Mirelurk attacks you with Screech, causing 7 points of damage!

* * *

>unlock door
(with Keys)
You unlock the exit.

>WEST
There is nothing in that direction.

>south
(first opening the exit)

Entrance to Bow
Well no place to go but down!

You can see an exit here.

>east
There is nothing in that direction.

>south
Lower Bow
There appears to be an old armory here to the left. Better go through the stuff just in case but I'm not expecting any laser tech. There's also a stairway to the Engine Room.

>west
Armory
Well, might as well take this old gun.

You already took the gun.

* * *

>south
Rivet City
A busling lively city, full with a market place to the east, bar and hotel.. But remember your task, finding Pinkerton won't be so easy.

A greeter sits by the entrance of rivet city.

Rivet City is well protected.

You can also see an exit here.

>east
Entrance to bow
Well no place to go but down!

>south
Lower Bow
There appears to be an old armory here. Better go through the stuff just in case but I'm not expecting any laser tech.

>WEST
Armory
Well, might as well take everything.

>take all
your Combat Shotgun: Taken.

>north
There is nothing in that direction.

>east
Lower Bow
There appears to be an old armory here. Better go through the stuff just in case but I'm not expecting any laser tech.

>north
Entrance to bow
Well no place to go but down!

>north
There is nothing in that direction.

>west
Rivet City
A busling lively city, full with a market place, bar and hotel.. But remember your task, finding Pinkerton won't be so easy.

Your friend Joe says "Hey! I heard there was a secret room in the city. Try looking around. I heard it's really old and no one has ever been there before."

Rivet City is well protected.

You can also see an exit here.

>attack guard
Violence isn't the answer to this one.

* * *

>north
Old Closet
A old closet with a rusty stand and some keys.

On Rusty Stand is Keys.

>TAKE KEYS
Taken.

>south
Rivet City
A busling lively city, full with a market place, bar and hotel.. But remember your task, finding Pinkerton won't be so easy.

Your friend Joe says "Hey! I heard there was a secret room in the city. Try looking around. I heard it's really old and no one has ever been there before."

Rivet City is well protected.

You can also see an exit here.

>east
Entrance to bow
Well no place to go but down!