You're in Rivet City. The goal is to find a scientist known as Pinkerton who has barricaded himself in the lower half of the ship. In order to get to him you're going to have to go through the bow.

FIND THE SCIENTIST
An Interactive Fiction by Harrison Yeh
Release 1 / Serial number 130304 / Inform 7 build 6G60 (I6/v6.32 lib 6/12N) SD

Rivet City
A busling lively city, full with a market place, bar and hotel.. But remember your task, finding Pinkerton won't be so easy.

A greeter sits by the entrance of rivet city.

Rivet City is well protected.

You can also see an exit here.

>attack guard
Violence isn't the answer to this one.

>attack joe
Don't need to attack him.

>x me
As good-looking as ever.

* * *

You're in Rivet City. The goal is to find a scientist known as Pinkerton who has barricaded himself in the lower half of the ship. In order to get to him you're going to have to go through the bow.

FIND THE SCIENTIST
An Interactive Fiction by Harrison Yeh
Release 1 / Serial number 130304 / Inform 7 build 6G60 (I6/v6.32 lib 6/12N) SD

Rivet City
A busling lively city, full with a market place, bar and hotel.. But remember your task, finding Pinkerton won't be so easy.

A greeter sits by the entrance of rivet city.

Rivet City is well protected.

You can also see an exit here.

>x desk
You can't see any such thing.

>take combat shotgun
You can't see any such thing.

* * *

You're in Rivet City. The goal is to find a scientist known as Pinkerton who has barricaded himself in the lower half of the ship. In order to get to him you're going to have to go through the bow.

FIND THE SCIENTIST
An Interactive Fiction by Harrison Yeh
Release 1 / Serial number 130304 / Inform 7 build 6G60 (I6/v6.32 lib 6/12N) SD

Rivet City
A busling lively city, full with a market place, bar and hotel.. But remember your task, finding Pinkerton won't be so easy.

A greeter sits by the entrance of rivet city.

Rivet City is well protected.

You can also see an exit here.

>x rivet city
You can't see any such thing.

* * *

You're in Rivet City. The goal is to find a scientist known as Pinkerton who has barricaded himself in the lower half of the ship. In order to get to him you're going to have to go through the bow.

FIND THE SCIENTIST
An Interactive Fiction by Harrison Yeh
Release 1 / Serial number 130304 / Inform 7 build 6G60 (I6/v6.32 lib 6/12N) SD

Rivet City
A busling lively city, full with a market place, bar and hotel.. But remember your task, finding Pinkerton won't be so easy.

A greeter sits by the entrance of rivet city.

Rivet City is well protected.

You can also see an exit here.

>north
Old Closet
A old closet with a rusty stand and some keys.

On Rusty Stand is Keys.

>take all
(Keys)
Taken.

>x combat shotgun
You see nothing special about your Combat Shotgun.

* * *

>take all
(Keys)
Taken.

>south
Rivet City
A busling lively city, full with a market place, bar and hotel.. But remember your task, finding Pinkerton won't be so easy.

Your friend Joe says "Hey! I heard there was a secret room in the city. Try looking around. I heard it's really old and no one has ever been there before."

Rivet City is well protected.

You can also see an exit here.

>east
Entrance to bow
Well no place to go but down!

>south
Lower Bow
There appears to be an old armory here. Better go through the stuff just in case but I'm not expecting any laser tech.

>WEST
Armory
Well, might as well take everything.

>take all
your Combat Shotgun: Taken.

>north
There is nothing in that direction.

>east
Lower Bow
There appears to be an old armory here. Better go through the stuff just in case but I'm not expecting any laser tech.

>north
Entrance to bow
Well no place to go but down!

>north
There is nothing in that direction.

>west
Rivet City
A busling lively city, full with a market place, bar and hotel.. But remember your task, finding Pinkerton won't be so easy.

Your friend Joe says "Hey! I heard there was a secret room in the city. Try looking around. I heard it's really old and no one has ever been there before."

Rivet City is well protected.

You can also see an exit here.

>attack guard
Violence isn't the answer to this one.

* * *

>north
Old Closet
A old closet with a rusty stand and some keys.

On Rusty Stand is Keys.

>TAKE KEYS
Taken.

>south
Rivet City
A busling lively city, full with a market place, bar and hotel.. But remember your task, finding Pinkerton won't be so easy.

Your friend Joe says "Hey! I heard there was a secret room in the city. Try looking around. I heard it's really old and no one has ever been there before."

Rivet City is well protected.

You can also see an exit here.

* * *

You're in Rivet City. The goal is to find a scientist known as Pinkerton who has barricaded himself in the lower half of the ship. In order to get to him you're going to have to go through the bow.

FIND THE SCIENTIST
An Interactive Fiction by Harrison Yeh
Release 1 / Serial number 130304 / Inform 7 build 6G60 (I6/v6.32 lib 6/12N) SD

Rivet City
A busling lively city, full with a market place, bar and hotel.. But remember your task, finding Pinkerton won't be so easy.

A greeter sits by the entrance of rivet city.

Rivet City is well protected.

You can also see an exit here.

>x me
I'm so cool. My sheriff's hat and shades could attract any lady of the wasteland.

* * *

You're in Rivet City. The goal is to find a scientist known as Pinkerton who has barricaded himself in the lower half of the ship. In order to get to him you're going to have to go through the bow.

FIND THE SCIENTIST
An Interactive Fiction by Harrison Yeh
Release 1 / Serial number 130304 / Inform 7 build 6G60 (I6/v6.32 lib 6/12N) SD

Rivet City
A busling lively city, full with a market place, bar and hotel.. But remember your task, finding Pinkerton won't be so easy.

A greeter sits by the entrance of rivet city.

Rivet City is well protected.

You can also see an exit here.

>x exit
The exit leads to the bow

>x rivet city
You can't see any such thing.

>x joe
Joe looks at you and says, "You need a key to get to the bow!."

>attack joe
Don't need to attack him.

>attack guard
Violence isn't the answer to this one.

* * *

You're in Rivet City. The goal is to find a scientist known as Pinkerton who has barricaded himself in the lower half of the ship. In order to get to him you're going to have to go through the bow.

FIND THE SCIENTIST
An Interactive Fiction by Harrison Yeh
Release 1 / Serial number 130304 / Inform 7 build 6G60 (I6/v6.32 lib 6/12N) SD

Rivet City
A busling lively city, full with a market place, bar and hotel.. But remember your task, finding Pinkerton won't be so easy.

A greeter sits by the entrance of rivet city.

Rivet City is well protected.

You can also see an exit here.

>x greeter
Joe looks at you and says, "You need a key to get to the bow!"

* * *

You're in Rivet City. The goal is to find a scientist known as Pinkerton who has barricaded himself in the lower half of the ship. In order to get to him you're going to have to go through the bow.

FIND THE SCIENTIST
An Interactive Fiction by Harrison Yeh
Release 1 / Serial number 130304 / Inform 7 build 6G60 (I6/v6.32 lib 6/12N) SD

Rivet City
A busling lively city, full with a market place, bar and hotel.. But remember your task, finding Pinkerton won't be so easy.

A greeter sits by the entrance of rivet city.

Rivet City is well protected.

You can also see an exit here.

>TALK TO JOE
That noun did not make sense in this context.

>speak to joe
I didn't understand that sentence.

>x joe
Joe looks at you and says, "You need a key to get to the bow!"

>x security guard
You see nothing special about Security Guard.

>x guard
You see nothing special about Security Guard.

>x soldier
You see nothing special about Security Guard.

>lift
That noun did not make sense in this context.

>north
Old Closet
A old closet with a rusty stand and some keys.

On Rusty Stand is Keys.

>take keys
Taken.

>south
Rivet City
A busling lively city, full with a market place, bar and hotel.. But remember your task, finding Pinkerton won't be so easy.

Your friend Joe says "Hey! I heard there was a secret room in the city. Try looking around. I heard it's really old and no one has ever been there before."

Rivet City is well protected.

You can also see an exit here.

>west
There is nothing in that direction.

>east
Entrance to bow
There appears to be an old armory here. Better go through the stuff just in case but I'm not expecting any laser tech.

* * *

You're in Rivet City. The goal is to find a scientist known as Pinkerton who has barricaded himself in the lower half of the ship. In order to get to him you're going to have to go through the bow.

FIND THE SCIENTIST
An Interactive Fiction by Harrison Yeh
Release 1 / Serial number 130304 / Inform 7 build 6G60 (I6/v6.32 lib 6/12N) SD

Rivet City
A busling lively city, full with a market place, bar and hotel.. But remember your task, finding Pinkerton won't be so easy.

A greeter sits by the entrance of rivet city.

Rivet City is well protected.

You can also see an exit here.

>x shrapnel
You can't see any such thing.

>north
Old Closet
A old closet with a rusty stand and some keys.

On Rusty Stand is Keys.

* * *

>take all
(Keys)
Taken.

>south
Rivet City
A busling lively city, full with a market place, bar and hotel.. But remember your task, finding Pinkerton won't be so easy.

A greeter sits by the entrance of rivet city.

Rivet City is well protected.

You can also see an exit here.

* * *

>west
There is nothing in that direction.

>EAST
Entrance to bow
Well no place to go but down!

>south
Lower Bow
There appears to be an old armory here to the left. Better go through the stuff just in case but I'm not expecting any laser tech. There's also a stairway to the Engine Room.

>west
Armory
Well, might as well take this old gun.

>take gun
Taken.

>take all
There are none at all available!

>east
Lower Bow
There appears to be an old armory here to the left. Better go through the stuff just in case but I'm not expecting any laser tech. There's also a stairway to the Engine Room.

>south
Engine
Mutated hostile creatures are wandering around.

You can see Mirelurk here.

>shoot mirelurk
What do you want to shoot Mirelurk with?

>gun
You attack Mirelurk with your Combat Shotgun, causing 32 points of damage!

Mirelurk attacks you with Nothing, causing 0 points of damage!

>south
There is nothing in that direction.

Mirelurk attacks you with Screech, causing 3 points of damage!

>attack mirelurk with gun
You attack with your Combat Shotgun, killing Mirelurk!