Game
An Interactive Fiction by Harrison Yeh
Release 1 / Serial number 130228 / Inform 7 build 6G60 (I6/v6.32 lib 6/12N) SD

Rivet City
A busling lively city, full with a market place, bar and hotel.. But remember your task, finding Pinkerton won't be so easy.

Your friend Joe says "Hey! I heard there was a secret room in the city. Try looking around. I heard it's really old and no one has ever been there before."

There's a security guard dressed in black armor armed with a standard 10 mm SMG.

You can also see an exit here.

>x desk
You can't see any such thing.

* * *

Game
An Interactive Fiction by Harrison Yeh
Release 1 / Serial number 130228 / Inform 7 build 6G60 (I6/v6.32 lib 6/12N) SD

Rivet City
A busling lively city, full with a market place, bar and hotel.. But remember your task, finding Pinkerton won't be so easy.

Your friend Joe says "Hey! I heard there was a secret room in the city. Try looking around. I heard it's really old and no one has ever been there before."

There's a security guard dressed in black armor armed with a standard 10 mm SMG.

You can also see an exit here.

>x rivet city
You can't see any such thing.

* * *

Game
An Interactive Fiction by Harrison Yeh
Release 1 / Serial number 130228 / Inform 7 build 6G60 (I6/v6.32 lib 6/12N) SD

Rivet City
A busling lively city, full with a market place, bar and hotel.. But remember your task, finding Pinkerton won't be so easy.

Your friend Joe says "Hey! I heard there was a secret room in the city. Try looking around. I heard it's really old and no one has ever been there before."

There's a security guard dressed in black armor armed with a standard 10 mm SMG.

You can also see an exit here.

>north
Old Closet
A old closet with a desk.

>take all
(your Combat Shotgun)
Taken.

>x combat shotgun
You see nothing special about your Combat Shotgun.